6
0 0
7 7
2 0 9 2 0 9 2 0 9 2 0 9 2 0 9 2 0 9 2 0 9 2 0 9 2 0 9 2 0 9 2 0 9 2 0 9 2 0 9 2 0 9 2 0 9 2 0 9 2 0 9 2 0 9 1 0 9 1 0 9 1 0 9 2 0 9 2 0 9 1 0 9 1 0 9 1 0 9 1 0 9 2 0 9 2 0 9 2 0 9 1 0 9 1 0 9 2 0 9 2 0 9 3 0 14 2 0 9 2 0 9 2 0 9 2 0 9 2 0 9 2 0 9 3 0 14 2 0 9 3 0 14 3 0 14 3 0 14 3 0 14 2 0 9 2 0 9 
7 7
7 7
2 0 9 1 0 9 2 0 9 2 0 9 2 0 9 1 0 9 1 0 9 1 0 9 1 0 9 2 0 9 2 0 9 2 0 9 2 0 9 2 0 9 2 0 9 2 0 9 2 0 9 2 0 9 3 0 14 1 0 9 1 0 9 1 0 9 1 0 9 1 0 9 1 0 9 1 0 9 1 0 9 2 0 9 2 0 9 2 0 9 1 0 9 1 0 9 2 0 9 2 0 9 1 0 9 2 0 9 2 0 9 3 0 14 3 0 14 2 0 9 2 0 9 1 0 9 2 0 9 3 0 14 3 0 14 3 0 14 3 0 14 2 0 9 2 0 9 
7 0
7 7
2 0 9 2 0 9 2 0 9 2 0 9 2 0 9 2 0 9 2 0 9 1 0 9 2 0 9 2 0 9 3 0 14 2 0 9 2 0 9 1 0 9 1 0 9 1 0 9 2 0 9 3 0 14 3 0 14 2 0 9 2 0 9 2 0 9 1 0 9 1 0 9 1 0 9 1 0 9 1 0 9 1 0 9 3 0 14 1 0 9 2 0 9 2 0 9 2 0 9 1 0 9 1 0 9 3 0 14 1 0 9 1 0 9 2 0 9 1 0 9 1 0 9 3 0 14 2 0 9 1 0 9 2 0 9 1 0 9 1 0 9 1 0 9 3 0 14 
14 7
7 7
1 0 9 1 0 9 3 0 14 3 0 14 1 0 9 2 0 9 2 0 9 1 0 9 3 0 14 3 0 14 1 0 9 1 0 9 2 0 9 2 0 9 1 0 9 1 0 9 3 0 14 3 0 14 1 0 9 1 0 9 2 0 9 2 0 9 1 0 9 1 0 9 1 0 9 1 0 9 2 0 9 2 0 9 1 0 9 1 0 9 2 0 9 2 0 9 1 0 9 1 0 9 2 0 9 1 0 9 1 0 9 1 0 9 2 0 9 1 0 9 1 0 9 2 0 9 2 0 9 1 0 9 2 0 9 1 0 9 1 0 9 2 0 9 2 0 9 
0 7
7 7
2 0 9 3 0 14 1 0 9 1 0 9 1 0 9 2 0 9 2 0 9 2 0 9 2 0 9 1 0 9 2 0 9 1 0 9 1 0 9 1 0 9 2 0 9 1 0 9 1 0 9 2 0 9 1 0 9 1 0 9 1 0 9 2 0 9 1 0 9 2 0 9 2 0 9 1 0 9 1 0 9 1 0 9 2 0 9 1 0 9 2 0 9 1 0 9 1 0 9 2 0 9 2 0 9 2 0 9 1 0 9 1 0 9 1 0 9 1 0 9 2 0 9 1 0 9 2 0 9 2 0 9 1 0 9 1 0 9 1 0 9 2 0 9 2 0 9 
14 0
7 7
2 0 9 2 0 9 2 0 9 2 0 9 2 0 9 2 0 9 2 0 9 1 0 9 2 0 9 2 0 9 2 0 9 2 0 9 1 0 9 2 0 9 1 0 9 1 0 9 1 0 9 1 0 9 1 0 9 1 0 9 2 0 9 1 0 9 2 0 9 2 0 9 2 0 9 2 0 9 1 0 9 2 0 9 1 0 9 2 0 9 2 0 9 1 0 9 1 0 9 1 0 9 2 0 9 1 0 9 2 0 9 2 0 9 1 0 9 1 0 9 2 0 9 2 0 9 1 0 9 1 0 9 1 0 9 1 0 9 1 0 9 2 0 9 2 0 9 
